28 22
###########################
#............#............#
#.####.#####.#.#####.####.#
#.####.#####.#.#####.####.#
#.........................#
#.####.#.#########.#.####.#
#......#.....#.....#......#
######.#####.#.#####.######
######.#...........#.######
######.#..###.###. #.######
..........#.....#..........
######.#..#######..#.######
######.#...........#.######
######.#..#######..#.######
#............#............#
#.####.#####.#.#####.####.#
#....#...............#....#
####.#.#.#########.#.#.####
#......#.....#.....#......#
#.##########.#.##########.#
#.........................#
###########################
